G.G.-.B.P.B.-.-.-.-
G.G.S.B.P.B.-.-.G.-
-.BS.W.BS.P.B.-.-.-.-
B.P.BS.-.B.-.-.-.-.-
P.B.-.-.-.-.-.-.-.-
B.-.-.S.-.-.B.-.-.-
-.-.GS.W.S.B.P.B.-.-
-.-.-.S.-.-.B.G.B.-
-.-.-.-.-.-.-.B.P.B
A.-.-.-.-.-.-.-.B.-