A.-.-.-.-.-.-.-.-.-
-.-.-.-.-.-.-.-.-.-
-.-.-.S.-.-.-.-.-.-
-.-.GS.W.S.-.-.-.-.-
-.-.-.S.-.B.-.-.-.-
-.-.-.-.B.P.B.-.S.-
-.-.-.-.-.B.-.S.W.S
-.-.B.-.-.S.S.W.GS._
-.B.P.B.S.W.S.S._.G
-.-.B.-.G.S.-.-.-.-