A.-.-.-.-.-.-.-.-.-
-.-.-.-.-.-.-.-.-.-
-.-.-.S.-.-.-.-.-.-
-.-.GS.W.S.-.-.-.-.-
-.-.-.S.-.B.-.-.-.-
-.-.-.-.B.P.B.-.S.-
-.-.-.-.-.B.-.SS.W.S
-.-.B.-.-.S.S.W.GSS._
-.B.P.B.S.W.S.S._.G
-.-.B.-.G.S.-.-.-.-