A.-.-.-.-.-.-.-.-.-
-.-.G.-.-.-.-.-.-.-
-.-.-.-.-.-.-.-.-.-
-.-.-.-.G.-.-.-.-.-
-.-.-.-.-.-.-.-.-.-
-.-.-.G.-.-.-.-.-.-
-.-.-.-.-.-.-.-.-.-
-.-.-.-.-.-.-.-.-.-
-.-.-.-.-.-.-.-.-.-
-.-.-.-.-.-.-.-.-.-
