A.-.-.-.-.-.-.B.-.-
-.-.G.-.-.-.B.P.B.-
-.-.-.-.-.-.-.B.-.-
-.-.-.B.G.-.-.-.-.-
-.-.B.P.B.-.-.-.-.-
-.-.B.GB.P.B.-.S.G.G
-.-.-.-.B.-.GS.W.S.-
-.-.-.-.-.-.-.S.-.S
-.-.-.-.-.-.B.-.S.W
-.-.-.-.-.B.P.B.-.GS