-.-.-.-.-.-.-.-.-.A
-.-.-.-.-.-.-.-.-.-
-.-.-.-.-.-.B.-.G.-
-.G.-.-.GB.B.P.B.-.G
-.-.G.B.P.B.B.-.S.-
-.-.S.-.GB.-.-.S.W.S
-.S.W.S.-.G.B.-.GS.G
-.-.S.G.-.B.P.B.-.B
-.B.-.-.-.-.B.G.B.P
B.P.B.G.-.-.-.-.G.B